111111111111111111111111111111111111
111112222222222221122222222222211111
111112111121111121121111121111211111
111113111121111121121111121111311111
111112111121111121121111121111211111
111112222222222222222222222222211111
111112111121121111111121121111211111
111112111121121111111121121111211111
111112222221122221122221122222211111
111111111121111101101111121111111111
111111111121111101101111121111111111
111111111121100000000001121111111111
111111111121101144441101121111111111
111111111121101100001101121111111111
100022222220001166661100022222220001
111111111121101111111101121111111111
111111111121101111111101121111111111
111111111121100000000001121111111111
111111111121101111111101121111111111
111111111121101111111101121111111111
111112222222222221122222222222211111
111112111121111121121111121111211111
111112111121111121121111121111211111
111113221122222222222222221122311111
111111121121121111111121121121111111
111111121121121111111121121121111111
111112222221122221122221122222211111
111112111111111121121111111111211111
111112111111111121121111111111211111
111115222222222222222222222222211111
111111111111111111111111111111111111